111111111111111111111111111111111111111111
10C00000000E00000000P00000000C000000000C01
111111111111111111111111111111111111111111
