11111111111111111111111
10000000000000C11110001
100110110110000111001C1
1000001C0C1000011000101
10011011011000000000001
100C1000000000110000101
11111001100000110001101
10000000C00000000111101
10011011111111001110001
1P011000000C00011110E01
11111111111111111111111
