11111111111111111111111111111111111111111111111111111111111111111
11111111111111111111111111111111111111111111111111111111111111111
11111111111111111111111111111111111111111111111111111111111111111
11111111111111111111111111111111111111111111111111111111111111111
11100000000000000000000000000000000000000000000000000000000001111
1110000000000000000000000000000000000000000000000000000E000001111
11100000000000000000000000000000000000000000000000000000000001111
11100000000000000000000000000000000000000000000000000000000001111
11100000000000000000000000000000000000000000000000000000000001111
11100000000000000000000000000000000000000000000000000000000001111
11100000000000000000000000000000000000000000000000000000000001111
11100000000000000000000000000000000000000000000000000000000001111
11100000000000000000000000000000000000000000000000000000000001111
11100000000000000000000000000000000000000000000000000000000001111
11100000000000000000000000000000000000000000000000000000000001111
11100000000000000000000000000000000000000000000000000000000001111
11100000000000000000000000000000000000000000000000000000000001111
1110000000000000000000000000000C000000000000000000000000000001111
11100000000000000000000000000000000000000000000000000000000001111
11100000000000000000000000000000000000000000000000000000000001111
11100000000000000000000000000000000000000000000000000000000001111
11100000000000000000000000000000000000000000000000000000000001111
11100000000000000000000000000000000000000000000000000000000001111
11100000000000000000000000000000000000000000000000000000000001111
11100000000000000000000000000000000000000000000000000000000001111
11100000000000000000000000000000000000000000000000000000000001111
11100000000000000000000000000000000000000000000000000000000001111
11100000000000000000000000000000000000000000000000000000000001111
111000000P0000000000000000000000000000000000000000000000000001111
11100000000000000000000000000000000000000000000000000000000001111
11100000000000000000000000000000000000000000000000000000000001111
11100000000000000000000000000000000000000000000000000000000001111
11111111111111111111111111111111111111111111111111111111111111111
11111111111111111111111111111111111111111111111111111111111111111
11111111111111111111111111111111111111111111111111111111111111111
11111111111111111111111111111111111111111111111111111111111111111
