11111111111
1P0CE1
11111111111
