11111111111111111
10P001000100000E1
1111110C010001001
10000110110C01111
1000000C000000001
11111111111111111
