111111111111
100C00000E01
100HALLO0001
10P000C00001
111111111111
