111111111
10P000E01
111111111
